1111111111
1P11111111
1E10000001
1C10000001
1110000001
1110000001
1111111111